2=>iki
6s=>galatasaray
abi=>ağabey
abiii=>ağabey
abijim=>ağabeycim
abim=>ağabeyim
abimi=>ağabeyimi
abı=>ağabey
abım=>ağabeyim
abımle=>abimle
acildi=>açıldı
acmadı=>açmadı
acıklama=>açıklama
adas=>adaş
aglamak=>ağlamak
agridi=>ağrıdı
ajdarin=>ajdarın
aksamm=>akşam
alacğım=>alacağım
aldattğını=>aldattığını
alemnde=>aleminde
allaaaah=>allah
allaaah=>allah
allam=>allahım
allh=>allah
altust=>altüst
alıcam=>alacağım
anlatılcak=>anlatılacak
anneşiim=>annem
ant=>antrenman
ant=>antalya
ark=>arkadaş
arkadasi=>arkadaşı
arkadassiniz=>arkadaşsınız
arkadasımı=>arkadaşımı
artıkk=>artık
arıyayım=>arayayım
asagdaydı=>asağıdaydı
asık=>aşık
atcak=>atacak
atesten=>ateşten
atmıştn=>atmıştın
attimmm=>attım
ayakkabılarr=>ayakkabılar
ayrildin=>ayrıldın
ayy=>ay
ayıltıyorrrr=>ayıltıyor
açmışşş=>açmış
açıyo=>açıyor
aşkımss=>aşkım
baana=>bana
babamin=>babamın
baglanirlar=>bağlanırlar
bakalim=>bakalım
bakim=>bakayım
bakimmmm=>bakayım
bakti=>baktı
bakçak=>bakacak
bakıyolarkı=>bakıyorlarki
balm=>balım
basicaksiniz=>basacaksınız
basili=>basılı
basim=>başım
bask=>başkanı
baska=>başka
baskanlik=>başkanlık
baskanını=>başkanını
baslamis=>başlamış
basm=>başım
basıosunuz=>basıyorsunuz
baygn=>baygın
bayılıyorum=>bayılıyorum
başarılısınız=>başarılısınız
başgan=>başkan
bebegim=>bebeğim
bebeim=>bebeğim
beeee=>beee
begeniyorum=>beğeniyorum
begenmıon=>beğenmiyorsun
beklemedıgın=>beklemediğim
beklicem=>bekleyeceğim
belirteyimm=>belirteyim
benle=>benimle
benm=>benim
benım=>benim
benımde=>benimde
beraberligi=>beraberliği
besiktasimin=>beşiktaşımın
bgn=>bugün
bi=>bir
bide=>birde
bikere=>birkere
biktim=>bıktım
bilim=>bileyim
biliyodum=>biliyordum
bilym=>bileyim
birak=>bırak
birlestiricem=>birleştireceğim
bisey=>birsey
bitanem=>birtanem
bitek=>birtek
biticek=>bitecek
bitiriyo=>bitiriyor
bizeee=>bize
bişey=>birşey
bjk=>beşiktaş
bosa=>boşa
boyle=>böyle
bugun=>bugün
bulmalıı=>bulmalı
butun=>bütün
buu=>bu
buyüzdn=>buyüzden
bı=>bir
bın=>bin
bırakin=>bırakın
bıtırır=>bitirir
bızım=>bizim
bşey=>birşey
candir=>candır
canim=>canım
caresi=>çaresi
cekip=>çekip
cekmekten=>çekmekten
ciftliginde=>çiftliğinde
cigdem=>ciğdem
cmtesi=>cumartesi
cnm=>canım
cnmm=>canım
cocugu=>çocuğu
cok=>çok
cook=>çok
cozemesem=>çözemesem
cüneyit=>cüneyt
cıcegııı=>çiçeği
cıcek=>çiçek
cık=>çık
cıkamayız=>çıkamayız
cıkmam=>çıkmam
cıksında=>çıksında
cıkıcam=>çıkacağım
cınım=>canım
da=>ta
dakka=>dakika
danısmanim=>danışmanım
de=>ta
de=>da
dedm=>dedim
degılsın=>degilsin
deiştiriyo=>değiştiriyor
deken=>derken
desem=>dersem
destekliyorummm=>destekliyorum
değiştiyorum=>değiştiriyorum
değlim=>değilim
dibii=>dibi
diceksin=>diyeceksin
die=>diye
dien=>diyen
dier=>diğer
diilmiş=>değilmiş
dinliceeem=>dinleyeceğim
dinliyrm=>dinliyorum
direktoru=>direktörü
diycenki=>diyeceksinki
diyince=>deyince
diyip=>deyip
diyo=>diyor
dokunduuu=>dokundu
dolasan=>dolaşan
donduruyo=>donduruyor
donem=>dönem
doniyiiii=>dönüyor
dostummm=>dostum
doğrusuuuuu=>doğrusu
doğus=>doğuş
duruyo=>duruyor
dustum=>düştüm
dusun=>düşün
dusundum=>düşündüm
döve=>döv
düdnkü=>dünkü
düşüncem=>düşüneceğim
düşünüyormş=>düşünüyormuş
dıger=>diğer
dıosunuz=>diyorsunuz
dışardan=>dışarıdan
ederım=>ederim
eglenmeye=>eğlenmeye
erk=>erkek
etiketliyip=>etiketleyip
etmicem=>etmeyeceğim
ettik=>şişhane
evett=>evet
evettttttttttt=>evet
evlenıcegım=>evleneceğim
eweeeeett=>evet
eşşek=>eşek
face=>facebook
farkınz=>farkınız
fb=>fenerbahçe
fenaaaaa=>fena
fenerbahcelii=>fenerbahçeli
feth=>fethettik
fln=>falan
foto=>fotoğraf
fotograflar=>fotoğraflar
fotosu=>fotoğrafı
frklı=>farklı
gazi=>gaziantep
gecen=>geçen
gecer=>geçer
gecmis=>geçmiş
gecırsem=>geçirsem
gelicem=>geleceğim
geliyim=>geleyim
geliyo=>geliyor
gelll=>gel
gelmee=>gelme
gelmiycek=>gelmeyecek
gelmiyon=>gelmiyorsun
gelmıyosun=>gelmiyorsun
gelnceye=>gelinceye
gelsinn=>gelsin
gelıcem=>geleceğim
gelırken=>gelirken
gelırı=>geliri
gelıyosun=>geliyorsun
genc=>genç
gercek=>gerçek
gerekiyodu=>gerekiyordu
getirim=>getiririm
gezmis=>gezmiş
geçiyon=>geçiyorsun
giderioz=>gideriyoruz
giderkeen=>giderken
gidicek=>gidecek
gidisle=>gidişle
gidiyo=>gidiyor
gidiyoruuuuum=>gidiyorum
gidiyyyyyoyoyoyo=>gidiyor
girecem=>gireceğim
gitarr=>gitar
gitceksen=>gideceksen
gonderiyor=>gönderiyor
gondern=>gönderin
gorunce=>görünce
gorusuuruz=>görüşürüz
gosterr=>gosterir
goz=>göz
gozde=>gözde
gozlukluyken=>gözlüklüyken
gozluğuyle=>gözlüğüyle
grıp=>grip
gs=>galatasaray
gucun=>gücün
gulmeeeek=>gülmek
gulmekten=>gülmekten
gundu=>gündü
gunes=>güneş
gunler=>günler
gunlerde=>günlerde
gunlerdeeen=>günlerden
gunumu=>günümü
gunü=>günü
guzel=>güzel
guzelce=>güzelce
guzellıgın=>güzelliğin
güldüüm=>güldüm
gülenn=>gülen
gülüyoooor=>gülüyor
gıbı=>gibi
gıyımıme=>giyimime
hadı=>hadi
hakli=>haklı
hallet=>b49hallet
harcıyosun=>harcıyorsun
hatı=>hattı
hayrlı=>hayırlı
haytım=>hayatım
hayvnlara=>hayvanlara
hbrim=>haberim
hedıye=>hediye
hic=>hiç
hicbi=>hiçbir
hicbir=>hiçbir
hizli=>hızlı
hiçbişey=>hiçbirşey
hklsn=>haklısın
huuuuu=>hu
hşsun=>hoşsun
icin=>için
iimiş=>iyimiş
ilaciydi=>ilacıydi
iliski=>ilişki
iltihp=>iltihap
inanmıyo=>inanmıyor
insallah=>inşallah
insanisin=>insanısın
iplemiycam=>iplemiycem
isin=>işin
ismarlarmsn=>ismarlarmısın
isre=>ise
ist=>istanbul
iste=>işte
iyim=>iyiyim
izlio=>izliyor
kacmazdi=>kaçmazdı
kalbme=>kalbime
kaldk=>kaldık
kalir=>kalır
kalmamistir=>kalmamiştır
kalmcagni=>kalmayacağını
kalmis=>kalmış
kapadım=>kapattım
kararsizim=>kararsızım
kardess=>kardeş
karsıma=>karşıma
karışıcaz=>karışıcağız
karşiim=>kardeşim
kiniyorum=>kınıyorum
kirilmasi=>kırılması
kitatap=>kitap
kizlar=>kızlar
klubu=>kulübü
kmde=>kimde
konustuunda=>konuştuğunda
konusuruz=>konuşuruz
konuşp=>konuşup
korkutcaksın=>korkutacaksın
kotu=>kötü
kskanclk=>kıskançlık
ksme=>küsme
kufur=>küfür
kulakligimi=>kulaklığımı
kusamıma=>kuşamıma
kusum=>kuşum
kuzi=>kuzen
kötüü=>kötü
kı=>ki
kım=>kim
kıralı=>kralı
kıskanıorm=>kıskanıyorm
kızııı=>kızı
lazim=>lazım
li=>lı
lütfennnn=>lütfen
lütfnnnn=>lütfen
lıyım=>liyim
maca=>maça
macı=>maçı
makyajim=>makyajım
mavii=>mavi
meşgüldm=>meşguldüm
mhb=>merhaba
mi=>mı
miii=>mi
mrb=>merhaba
msj=>mesaj
msj=>mesj
msjı=>mesajı
mu=>mü
mumkun=>mümkün
nalıncı=>yalancı
nası=>nasıl
nbr=>naber
nerde=>nerede
nerden=>nereden
nerdeyse=>neredeyse
neyseee=>neyse
nsl=>nasıl
nıye=>niye
off=>of
offf=>of
oglum=>oğlum
okaann=>okan
okuncak=>okunacak
okuyomuş=>okuyormuş
olablrsn=>olabilirsin
olak=>olalım
oldug=>olduğu
oldum=>öldüm
olduğumm=>olduğum
olll=>ol
ollsaaaaa=>olsa
olm=>oğlum
olmamalii=>olmamalı
olmasi=>olması
olmayi=>olmayı
olmazdi=>olmazdı
olmucam=>olmayacağım
olmuo=>olmuyor
olmuyoo=>olmuyor
olmş=>olmuş
olsn=>olsun
olsunnnn=>olsun
olucam=>olacağım
olum=>oğlum
olummm=>oğlum
oluoo=>oluyor
oluyo=>oluyor
omer=>ömer
onlardn=>onlardan
onlari=>onları
oo=>o
oyle=>öyle
oyunculuktr=>oyunculuktur
ozel=>özel
ozun=>özün
pedindesin=>peşindesin
reytigde=>reytingde
ruyaalaar=>rüyalar
ruyalaar=>rüyalar
ruyalar=>rüyalar
sacıma=>saçıma
sagol=>sağol
saka=>şaka
sakın=>sakin
salsamııı=>salsamı
samp=>şampiypon
sampiyonu=>şampiyonu
sankı=>sanki
sanmanz=>sanmanız
sanıyodu=>sanıyordu
saol=>sağol
sarkilar=>şarkılar
sarkisinin=>şarkısının
sarkiya=>şarkıya
sarkılarının=>şarkılarının
sataşıyım=>sataşayım
secimine=>seçimine
sehrin=>şehrin
sekerli=>şekerli
seniii=>seni
senn=>senin
sesleniyorm=>sesleniyorum
severım=>severim
sevgılımden=>sevgilimden
seviyo=>seviyor
seviyosun=>seviyorsun
seyler=>şeyler
seçiyolar=>seçiyorlar
sifreyi=>şifreyi
simdi=>şimdi
simdiden=>şimdiden
sira=>sıra
sismis=>şişmiş
skldeydm=>şekildeyim
slm=>selam
snaa=>sana
soyle=>söyle
soyledim=>söyledim
sozleri=>sözleri
su=>şu
suan=>şuan
sureden=>süreden
surpriz=>supriz
suru=>sürü
svg=>sevgiler
syesinde=>sayesinde
söylüceeek=>söyleyecek
söylüyooor=>söylüyor
süperr=>süper
sürpriz=>süpriz
sımdı=>şimdi
taam=>tamam
tabiii=>tabi
takim=>takım
takipcim=>takipçim
takmis=>takmış
takmlarn=>takmların
tanimasam=>tanımasam
tatlm=>tatlım
telfona=>telefona
tmm=>tamam
tskkr=>teşekkür
turlu=>türlü
tusu=>tuşu
tutuyo=>tutuyor
tükeniyodu=>tükeniyordu
tşk=>teşekkür
ugrararız=>uğrarız
ugrasmıcm=>ugraşmayacağım
ulkeleri=>ülkeleri
umarim=>umarım
unuttm=>unuttum
uyaniyorum=>uyanıyorum
uzulme=>üzülme
uğrştğm=>uğraştığım
vardi=>vardı
varmis=>varmış
vericem=>vereceğim
veriyodu=>veriyordu
yaa=>ya
yaaa=>ya
yakin=>yakın
yakışıyo=>yakışıyor
yalniz=>yalnız
yalnizlar=>yalnızlar
yanii=>yani
yanliyrlar=>yanılıyorlar
yanı=>yani
yapiyorum=>yapıyorum
yapmayn=>yapmayın
yapmışımm=>yapmışım
yapmışş=>yapmış
yapsınn=>yapsın
yapsınnn=>yapsın
yaptim=>yaptım
yapıcam=>yapacağım
yapıyo=>yapıyor
yapıyoruum=>yapıyorum
yapıyosun=>yapıyorsun
yarinlarda=>yarınlarda
yasadm=>yaşadım
yasgunu=>yaşgünü
yasin=>yaşın
yasındakı=>yaşındaki
yatiyo=>yatıyor
yavrumm=>yavrum
yawrım=>yavrum
yazdim=>yazdım
yazmamissiniz=>yazmamişsınız
yaşadıgım=>yaşadığım
yaşıyo=>yaşıyor
yea=>ya
yerrr=>yer
yetr=>yeter
yi=>u
yigooooook=>yok
yikamamistik=>yıkamamıştık
yiyim=>yiyeyim
yiyodum=>yiyordum
yoldaym=>yoldayım
yrinde=>yerinde
yuklenıyolar=>yükleniyorlar
yuusftan=>yusuftan
yüzümee=>yüzüme
yüüz=>yüz
yıne=>yine
zaan=>zaman
ziyaretee=>ziyarete
zmn=>zaman
zorudamıyam=>zorundamıyım
âşık=>aşık
çalcam=>çalacağım
çalışsınnnnnnn=>çalışsın
çarpark=>çarparak
çokk=>çok
çoook=>çok
çooook=>çok
çoooook=>çok
öecem=>öleceğim
öle=>öyle
önemliii=>önemli
öğrncinin=>öğrencinin
üjbej=>üçbeş
üsündeki=>üstündeki
ğeçmiş=>geçmiş
ıcın=>için
ıle=>ile
ılerde=>ileride
ıstedıgın=>istediğin
şarkısının=>şarkının
şarkıı=>şarkı
şeyy=>şey
şişhaneden=>den